0 75 4110 3048 2267 974 4190 3302 4758 3044 3095 3986
75 0 4070 2999 2214 901 4137 3239 4701 2970 3021 3914
4110 4070 0 1172 1973 3496 891 1815 1415 3673 3777 2996
3048 2999 1172 0 817 2350 1172 995 1797 2648 2755 2315
2267 2214 1973 817 0 1533 1924 1188 2497 2208 2312 2324
974 901 3496 2350 1533 0 3417 2410 3935 2114 2175 3014
4190 4137 891 1172 1924 3417 0 1233 651 3086 3184 2202
3302 3239 1815 995 1188 2410 1233 0 1586 1877 1979 1321
4758 4701 1415 1797 2497 3935 651 1586 0 3285 3374 2177
3044 2970 3673 2648 2208 2114 3086 1877 3285 0 107 1360
3095 3021 3777 2755 2312 2175 3184 1979 3374 107 0 1412
3986 3914 2996 2315 2324 3014 2202 1321 2177 1360 1412 0